v,v,v,v,v,v,v,v,v,v,w,g,g,g,w,v,v,v,v,v,v,v,v,v,v
v,v,v,v,v,v,v,v,v,v,w,g,g,g,w,v,v,v,v,v,v,v,v,v,v
v,v,v,v,v,v,v,v,v,v,w,g,g,g,w,v,v,v,v,v,v,v,v,v,v
v,v,v,v,v,v,v,v,v,v,w,g,g,g,w,v,v,v,v,v,v,v,v,v,v
v,v,v,v,v,v,v,v,v,v,w,g,g,g,w,v,v,v,v,v,v,v,v,v,v
v,v,v,v,v,v,v,v,v,v,w,g,g,g,w,v,v,v,v,v,v,v,v,v,v
v,v,v,v,v,v,v,v,v,v,w,g,g,g,w,v,v,v,v,v,v,v,v,v,v
v,v,v,v,v,v,v,v,v,v,w,g,g,g,w,v,v,v,v,v,v,v,v,v,v
v,v,v,v,v,v,v,v,v,w,g,g,g,g,g,w,v,v,v,v,v,v,v,v,v
v,v,v,v,v,v,v,v,w,g,g,g,g,g,g,g,w,v,v,v,v,v,v,v,v
w,w,w,w,w,w,w,w,g,g,g,g,g,g,g,g,g,w,w,w,w,w,w,w,w
g,g,g,g,g,g,g,g,g,g,g,s,g,b,g,g,g,g,g,g,g,g,g,g,g
g,g,g,g,g,g,g,g,g,g,g,g,g,g,g,g,g,g,g,g,g,g,g,g,g
g,g,g,g,g,g,g,g,g,g,g,b,g,b,g,g,g,g,g,g,g,g,g,g,g
w,w,w,w,w,w,w,w,g,g,g,g,g,g,g,g,g,w,w,w,w,w,w,w,w
v,v,v,v,v,v,v,v,w,g,g,g,g,g,g,g,w,v,v,v,v,v,v,v,v
v,v,v,v,v,v,v,v,v,w,g,g,g,g,g,w,v,v,v,v,v,v,v,v,v
v,v,v,v,v,v,v,v,v,v,w,g,g,g,w,v,v,v,v,v,v,v,v,v,v
v,v,v,v,v,v,v,v,v,v,w,g,g,g,w,v,v,v,v,v,v,v,v,v,v
v,v,v,v,v,v,v,v,v,v,w,g,g,g,w,v,v,v,v,v,v,v,v,v,v
v,v,v,v,v,v,v,v,v,v,w,g,g,g,w,v,v,v,v,v,v,v,v,v,v
v,v,v,v,v,v,v,v,v,v,w,g,g,g,w,v,v,v,v,v,v,v,v,v,v
v,v,v,v,v,v,v,v,v,v,w,g,g,g,w,v,v,v,v,v,v,v,v,v,v
v,v,v,v,v,v,v,v,v,v,w,g,g,g,w,v,v,v,v,v,v,v,v,v,v
v,v,v,v,v,v,v,v,v,v,w,g,g,g,w,v,v,v,v,v,v,v,v,v,v