w,w,w,w,w,w,w,w,w,w,w,g,g,g,w,w,w,w,w,w,w,w,w,w,w
w,g,g,g,g,g,g,g,g,g,g,g,g,g,g,g,g,g,g,g,g,g,g,g,w
w,g,g,g,g,g,g,g,g,g,g,g,g,g,g,g,g,g,g,g,g,g,g,g,w
w,g,g,g,g,g,g,g,g,g,g,g,g,g,g,g,g,g,g,g,g,g,g,g,w
w,g,g,g,w,w,w,w,w,w,w,w,w,w,w,w,w,w,w,w,w,g,g,g,w
w,g,g,g,w,v,v,v,v,v,v,v,v,v,v,v,v,v,v,v,w,g,g,g,w
w,g,g,g,w,v,v,v,v,v,v,v,v,v,v,v,v,v,v,v,w,g,g,g,w
w,g,g,g,w,v,v,v,v,v,v,v,v,v,v,v,v,v,v,v,w,g,g,g,w
w,g,g,g,w,v,v,v,v,v,v,v,v,v,v,v,v,v,v,v,w,g,g,g,w
w,g,g,g,w,v,v,v,v,v,v,v,v,v,v,v,v,v,v,v,w,g,g,g,w
w,g,g,g,w,v,v,v,v,v,v,v,v,v,v,v,v,v,v,v,w,g,g,g,w
g,g,g,g,w,v,v,v,v,v,v,v,v,v,v,v,v,v,v,v,w,g,g,g,g
g,g,g,g,w,v,v,v,v,v,v,v,v,v,v,v,v,v,v,v,w,g,g,g,g
g,g,g,g,w,v,v,v,v,v,v,v,v,v,v,v,v,v,v,v,w,g,g,g,g
w,g,g,g,w,v,v,v,v,v,v,v,v,v,v,v,v,v,v,v,w,g,g,g,w
w,g,g,g,w,v,v,v,v,v,v,v,v,v,v,v,v,v,v,v,w,g,g,g,w
w,g,g,g,w,v,v,v,v,v,v,v,v,v,v,v,v,v,v,v,w,g,g,g,w
w,g,g,g,w,v,v,v,v,v,v,v,v,v,v,v,v,v,v,v,w,g,g,g,w
w,g,g,g,w,v,v,v,v,v,v,v,v,v,v,v,v,v,v,v,w,g,g,g,w
w,g,g,g,w,v,v,v,v,v,v,v,v,v,v,v,v,v,v,v,w,g,g,g,w
w,g,g,g,w,w,w,w,w,w,w,w,w,w,w,w,w,w,w,w,w,g,g,g,w
w,g,g,g,g,g,g,g,g,g,g,g,g,g,g,g,g,g,g,g,g,g,g,g,w
w,g,g,g,g,g,g,g,g,g,g,g,g,g,g,g,g,g,g,g,g,g,g,g,w
w,g,g,g,g,g,g,g,g,g,g,g,g,g,g,g,g,g,g,g,g,g,g,g,w
w,w,w,w,w,w,w,w,w,w,w,g,g,g,w,w,w,w,w,w,w,w,w,w,w