w,w,w,w,w,w,w,w,w,w,w,w,w,w,w,w,w,w,w,w,w,w,w,w,w,w,w,w,w,w,w,w,w,w,w,w,w,w,w,w,w,w,w,w,w,w,w,w,w
w,g,g,g,g,g,g,g,g,g,g,g,g,g,g,g,g,g,g,g,g,g,g,g,w,w,w,w,w,w,w,w,w,w,w,w,w,w,w,w,w,w,w,w,w,w,w,w,w
w,g,g,g,g,g,g,g,g,g,g,g,g,g,g,g,g,g,g,g,g,g,g,g,w,w,w,w,w,w,w,w,w,w,w,w,w,w,w,w,w,w,w,w,w,w,w,w,w
w,g,g,g,g,g,g,g,g,g,g,g,g,g,g,g,g,g,g,g,g,g,g,g,w,w,w,w,w,w,w,w,w,w,w,w,w,w,w,w,w,w,w,w,w,w,w,w,w
w,g,g,g,g,g,g,g,g,g,g,g,g,g,g,g,g,g,g,g,g,g,g,g,w,w,w,w,w,w,w,w,w,w,w,w,w,w,w,w,w,g,g,g,g,g,g,g,w
w,g,g,g,g,w,w,w,w,g,g,g,g,g,g,g,w,w,w,w,g,g,g,g,w,w,w,w,w,w,w,w,w,w,w,w,w,w,w,w,w,g,g,g,g,g,g,g,w
w,g,g,g,g,w,w,w,w,g,g,g,g,g,g,g,w,w,w,w,g,g,g,g,w,w,w,w,w,w,w,w,w,w,w,w,w,w,w,w,w,g,g,g,g,g,g,g,w
w,g,g,g,g,w,w,w,w,g,g,g,g,g,g,g,w,w,w,w,g,g,g,g,w,w,w,w,w,w,w,w,w,w,w,w,w,w,w,w,w,g,g,g,g,g,g,g,w
w,g,g,g,g,w,w,w,w,g,g,g,g,g,g,g,w,w,w,w,g,g,g,g,w,w,w,w,w,w,w,w,w,w,w,w,w,w,w,w,w,g,g,g,g,g,g,g,w
w,g,g,g,g,g,g,g,g,g,g,g,g,g,g,g,g,g,g,g,g,g,g,g,w,w,w,w,w,w,w,w,w,w,w,w,w,w,w,w,w,g,g,g,g,g,g,g,w
w,g,g,g,g,g,g,g,g,g,g,g,g,g,g,g,g,g,g,g,g,g,g,g,w,w,w,w,w,w,w,w,w,w,w,w,w,w,w,w,w,g,g,g,g,g,g,g,w
w,g,g,g,g,g,g,g,g,g,g,g,g,g,g,g,g,g,g,g,g,g,g,g,w,w,w,w,w,w,w,w,w,w,w,w,w,w,w,w,w,g,g,g,g,g,g,g,w
w,g,g,g,g,g,g,g,g,g,g,g,g,g,g,g,g,g,g,g,g,g,g,g,w,w,w,w,w,w,w,w,w,w,w,w,w,w,w,w,w,g,g,g,p,g,g,g,w
w,g,g,g,g,g,g,g,g,g,g,g,g,g,g,g,g,g,g,g,g,g,g,g,w,w,w,w,w,w,w,w,w,w,w,w,w,w,w,w,w,g,g,g,g,g,g,g,w
w,g,g,g,g,g,g,g,g,g,g,g,g,g,g,g,g,g,g,g,g,g,g,g,w,w,w,w,w,w,w,w,w,w,w,w,w,w,w,w,w,g,g,g,g,g,g,g,w
w,g,g,g,g,g,g,g,g,g,g,g,g,g,g,g,g,g,g,g,g,g,g,g,w,w,w,w,w,w,w,w,w,w,w,w,w,w,w,w,w,g,g,g,g,g,g,g,w
w,g,g,g,g,w,w,w,w,g,g,g,g,g,g,g,w,w,w,w,g,g,g,g,w,w,w,w,w,w,w,w,w,w,w,w,w,w,w,w,w,g,g,g,g,g,g,g,w
w,g,g,g,g,w,w,w,w,g,g,g,g,g,g,g,w,w,w,w,g,g,g,g,w,w,w,w,w,w,w,w,w,w,w,w,w,w,w,w,w,g,g,g,g,g,g,g,w
w,g,g,g,g,w,w,w,w,g,g,g,g,g,g,g,w,w,w,w,g,g,g,g,w,w,w,w,w,w,w,w,w,w,w,w,w,w,w,w,w,g,g,g,g,g,g,g,w
w,g,g,g,g,w,w,w,w,g,g,g,g,g,g,g,w,w,w,w,g,g,g,g,w,w,w,w,w,w,w,w,w,w,w,w,w,w,w,w,w,g,g,g,g,g,g,g,w
w,g,g,g,g,g,g,g,g,g,g,g,g,g,g,g,g,g,g,g,g,g,g,g,w,w,w,w,w,w,w,w,w,w,w,w,w,w,w,w,w,g,g,g,g,g,g,g,w
w,g,g,g,g,g,g,g,g,g,g,g,g,g,g,g,g,g,g,g,g,g,g,g,w,w,w,w,w,w,w,w,w,w,w,w,w,w,w,w,w,w,w,w,w,w,w,w,w
w,g,g,g,g,g,g,g,g,g,g,g,g,g,g,g,g,g,g,g,g,g,g,g,w,w,w,w,w,w,w,w,w,w,w,w,w,w,w,w,w,w,w,w,w,w,w,w,w
w,g,g,g,g,g,g,g,g,g,g,g,g,g,g,g,g,g,g,g,g,g,g,g,w,w,w,w,w,w,w,w,w,w,w,w,w,w,w,w,w,w,w,w,w,w,w,w,w
w,w,w,w,w,w,w,w,w,w,w,w,w,w,w,w,w,w,w,w,w,w,w,w,w,w,w,w,w,w,w,w,w,w,w,w,w,w,w,w,w,w,w,w,w,w,w,w,w